C 9
#########
#########
#       #
#  #    #
#  # FE #
#@@#    #
####  A #
#########
#########

F 5
#####
#   #
#   #
#   #
#####

E 5
#####
#   #
#   #
#   #
## ##

