C 11
###########
#######@###
####### ###
##      ###
###   @####
### #######
###     ###
###  FA ###
###  E  ###
###     ###
###########

F 5
     
     
     
     
#####

E 5
#####
     
     
     
     

