C 9
#########
#########
#       #
#  #    #
#  # DD #
#@@#    #
####D  E#
#########
#########

D 5
#####
#   #
#   #
#   #
#   #

E 5
#####
#   #
#   #
#   #
#####

