C 9
#########
## ######
##  E  @#
##      #
##     @#
#      ##
## A    #
##   # E#
#########

E 5
## ##
#####
 ####
#####
#####

