C 9
#### ####
####   @#
#### A  #
####   E#
####   F#
####   G#
####    #
####C@ C#
#########

E 5
#####
#   #
#   #
#   #
#####

F 5
#####
#   #
#   #
#   #
#####

G 5
#####
#   #
#   #
#   #
#####

