C 9
#########
#@    ###
# C   ###
#     ###
# C   ##A
#     ###
#@## ####
###@  ###
#########

