C 7
#######
#C  C #
#     #
   A  #
#    C#
#E   ##
#######

E 3
###
#@#
# #

