C 11
##### #####
###    @@@#
###       #
###  A    #
##        #
## ########
##        #
###  C C  #
###       #
###       #
##### #####

