C 9
#### ####
#     #@#
#     #@#
# C E # #
#      @#
# A E ###
#     ###
#     ###
#########

E 5
#####
#####
    #
##  #
#####

