C 7
#######
#     #
#  E A#
#     #
###  E#
#######
#######

E 7
#######
#     #
#     #
      #
#F    #
#     #
#######

F 3
###
 @#
###

