C 9
#########
###  @###
##E  @###
##     ##
######F##
##      #
##E   A #
###     #
#########

E 3
###
#  
# #

F 5
#####
#   #
#   #
#   #
#####

