C 11
##### #####
#     #####
# A E######
#    ## ###
# C       #
  ##      #
#####     #
#####    @#
#####    @#
#####    @#
###########

E 5
#####
#   #
#   #
#   #
#####

