C 9
#########
#   @   #
#       #
#  F D  #
#@  A  @#
#  G H  #
#       #
#   @   #
#########

F 5
#####
#   #
#   #
#   #
#####

D 5
#####
#   #
#   #
#   #
#####

G 5
#####
#   #
#   #
#   #
#####

H 3
###
#@#
# #

