C 9
#########
######C##
##    D##
##   #E##
## A #H##
##   #I##
##    J##
##     ##
######K##

D 5
#####
#   #
#   #
#   #
#####

E 3
###
F@#
###

F 5
#####
#   #
#   #
#   #
#####

H 3
###
 @#
###

I 5
#####
#   #
#   #
#   #
#####

J 5
#####
#   #
#   #
#   #
#####

K 5
#####
#   #
#   #
#   #
#####

