C 11
###########
#####C#####
#    B#####
# A   #####
#   #B#####
#   #B#####
#   #H#####
#   #B#####
#   #B#####
#   #B#####
#   #B#####

H 3
###
 @#
###

