C 9
#########
#C   ####
#E  A####
#    ####
#F   ####
#G   ####
#H#######
#I#######
#J## ####

E 5
#####
#   #
#   #
#   #
#####

F 5
#####
#   #
#   #
#   #
#####

G 5
#####
#   #
#   #
#   #
#####

H 3
###
#@#
# #

I 5
#####
#   #
#   #
#   #
#####

J 5
#####
#   #
#   #
#   #
#####

