C 9
#   #D###
#   #E###
#   #F###
# A #H###
#   #I###
#    K###
#   C  ##
#########
#########

D 5
#####
#   #
#   #
#   #
#####

E 3
###
#@#
# #

F 5
#####
#   #
#   #
#   #
#####

H 5
#####
#   #
#   #
#   #
#####

I 3
###
J@#
###

J 5
#####
#   #
#   #
#   #
#####

K 5
#####
#   #
#   #
#   #
#####

