C 9
#########
####C  C#
####B A #
###FBH# #
BJBBBBOC#
###PB####
####B####
####B####
####T####

F 5
#####
#####
#####
###  
### #

H 5
## ##
## ##
## ##
   ##
#####

J 5
#####
#####
#####
     
#####

O 5
#####
 @###
#####
#####
#####

P 5
### #
###  
#####
#####
#####

T 5
### #
### #
### #
### #
### #

