C 7
#######
# BBBGB
# BBBBM
# BBPBB
#C#S###
#  A   
#######

G 5
#####
#####
#####
###@#
### #

M 5
### #
### #
### #
### #
### #

P 5
### #
### #
### #
### #
### #

S 5
### #
### #
##  #
## ##
## ##

