C 9
#########
#########
###     #
### A C #
###     #
### EFG #
@ @@@   #
#@#######
#########

E 5
#####
#   #
#   #
#   #
#####

F 5
#####
#   #
#   #
#   #
#####

G 5
#####
#   #
#   #
#   #
#####

