C 9
#########
####C####
BBB   A@#
####B####
###@B####
####B####
###@B####
###@B####
####C####

