C 9
#########
#  ######
#  DEGHIJ
# C######
#  ######
#  ######
##A #####
##  #####
#########

D 5
#####
#   #
#   #
#   #
#####

E 5
#####
#   #
  #F#
###@#
#####

F 5
#####
#   #
#   #
#   #
#####

G 5
#####
#   #
#   #
#   #
#####

H 5
#####
#   #
#   #
#   #
#####

I 3
# #
#@#
###

J 5
#####
#   #
#   #
#   #
#####

