C 9
#########
##     ##
## G D ##
##     ##
## I #J##
##   #H##
######E##
#####@F##
#########

G 3
###
###
# #

D 3
###
###
# #

I 3
# #
# #
###

J 5
#####
#   #
#   #
#   #
#####

H 5
#####
#   #
#   #
#   #
#####

E 5
#####
#   #
#   #
#   #
#####

F 5
#####
#   #
#   #
#   #
#####

