C 7
#######
### G##
#    ##
#D  F##
#    ##
### H##
#######

G 5
#####
#   #
#   #
#   #
#####

D 3
###
 E 
###

E 3
###
 @#
###

F 5
#####
#   #
#   #
#   #
#####

H 5
#####
#   #
#   #
#   #
#####

