C 7
#######
#   E##
#     #
#@   D#
#    ##
# HGF##
#######

E 3
#@#
###
###

D 3
# #
# #
# #

H 5
#####
#   #
#   #
#   #
#####

G 5
#####
#   #
#   #
#   #
#####

F 5
#####
#   #
#   #
#   #
#####

