C 9
#########
#       #
# @ @ A #
#       #
# @ C E  
#       #
##  @   #
##      #
#########

E 9
#########
#       #
#       #
#       #
    E   #
#       #
#       #
#       #
#########

