C 7
#######
#     #
#  E  #
#    A#
#  F  #
#     #
#######

E 9
#########
#########
#@      #
#@#     #
#@# E   #
###     #
###     #
###    @#
#### ####

F 7
### ###
#     #
#     #
#  F  #
#     #
#     #
#######

