C 9
#########
      ###
  D C ###
      ###
  G A  EF
      ###
#########
 C#######
#########

D 5
#####
#   #
#   #
#   #
#####

G 5
#####
#   #
#   #
#   #
#####

E 5
#####
#   #
#   #
#   #
#####

F 3
###
#@#
# #

