C 11
###########
###########
#####   ###
#####D  ###
#####E  ###
#      A###
#####G  ###
#####H  ###
#####I  ###
#####   ###
###########

D 5
#####
#   #
#   #
#   #
#####

E 3
# #
#@#
###

G 5
#####
#   #
#   #
#   #
#####

H 7
#######
###   #
###   #
@@@@#  
#######
#######
#######

I 5
#####
#   #
#   #
#   #
#####

