C 11
###########
####G     #
######F   #
#    # #  #
#    ###  #
          #
#     C   #
#         #
##E   A   #
## #      #
##### #####

G 5
#####
#   #
#   #
#   #
#####

F 3
###
 @#
###

E 5
#####
#   #
#   #
#   #
#####

