C 7
#######
#  A  #
#     #
# E F #
#     #
#     #
#######

E 5
#####
#   #
#   #
#   #
#####

F 3
#@#
###
#@#

