C 9
#### ####
#       #
#   #   #
#       #
#  A F@ #
#       #
#  C E@ #
#       #
#########

F 5
#####
#   #
#   #
#   #
#####

E 7
### ###
#@#   #
# #   #
#@    #
#     #
#     #
#######

