C 7
#######
#     #
# H E #
#A G  #
# I F #
#    @#
#######

H 5
#####
#   #
#   #
#   #
#####

E 5
#####
#   #
#   #
#   #
#####

G 5
##@##
#####
@###@
#####
##@##

I 5
#####
#   #
#   #
#   #
#####

F 5
#####
#   #
#   #
#   #
#####

