C 7
#######
#    @#
# I G #
#F   A#
# E H #
#     #
#######

I 5
#####
#   #
#   #
#   #
#####

G 5
#####
#   #
#   #
#   #
#####

F 5
#####
#   #
#   #
#   #
#####

E 5
#####
#####
@@@@#
#####
#####

H 5
#####
#   #
#   #
#   #
#####

