C 9
#########
#A #  ###
#   D ###
#####E###
##@## ###
## ## ###
##@    @#
#########
#########

D 5
#####
#   #
#   #
#   #
#####

E 5
## ##
#  ##
#    
#####
#####

