C 9
#########
##     ##
## A E ##
##     ##
## G F ##
##     ##
####G  ##
#########
#########

E 5
#####
#   #
#   #
#   #
#####

F 5
#####
#   #
#   #
#   #
#####

G 9
#### ####
#  # ####
#       #
#   #   #
#     #  
#     ###
#    @@##
#     ###
#########

