C 7
#######
#     #
# @ A #
#     #
# F   #
#    E#
#######

F 5
#####
#   #
#   #
#   #
#####

E 5
## ##
#@  #
  # #
#   #
#####

