C 7
#######
#     #
# A E #
#     #
#   F #
#     #
#######

E 5
#####
#   #
#   #
#   #
#####

F 9
#### ####
###     #
###     #
#@#     #
# #  F  #
#@      #
###     #
###     #
#########

