C 7
#######
#     #
# D E #
#     #
# @ F #
#     #
#######

D 5
#####
#   #
#   #
#   #
#####

E 7
       
       
       
       
     # 
       
    #@#

F 5
#####
#   #
#   #
#   #
#####

