C 9
#########
#  #    #
#       #
#   # D #
#     A #
#  #  E #
#       #
#   #   #
#########

D 5
# # #
# #@#
  ###
#####
#####

E 5
#####
#####
#####
#   #
# # #

