C 7
#######
#    @#
# A   #
#     #
###   #
#@ D  #
#######

D 5
#####
#   #
#   #
#   #
#####

