C 9
#########
#########
#E D E#E#
#     # #
#F   A#@#
#     #@#
#E H E#@#
#########
#########

D 5
## ##
## ##
#  ##
# ###
# ###

E 5
     
     
     
     
     

F 5
 ####
  ###
# ###
# ###
# ###

H 5
#####
#####
#####
@####
 ####

