C 7
#######
#@    #
#@F A #
#     #
# E   #
#   C##
### ###

F 5
#####
#####
###  
### #
### #

E 5
### #
###@#
#####
#####
#####

