C 9
####D# ##
####E A##
####G####
####H####
###IC####
####L####
####M####
####N####
####O####

D 5
### #
    #
###  
### #
### #

E 5
#####
#   #
#   #
#   #
#####

G 5
#####
#   #
#   #
#   #
#####

H 5
#####
#   #
#   #
#   #
#####

I 5
##  #
##J  
##K##
@@@  
#####

J 5
#####
#   #
#   #
#   #
#####

K 5
#####
#   #
#   #
#   #
#####

L 5
#####
#   #
#   #
#   #
#####

M 5
#####
#   #
#   #
#   #
#####

N 5
#####
#   #
#   #
#   #
#####

O 5
#####
#   #
#   #
#   #
#####

