C 9
#########
#D EFG C#
#       #
#   A   #
       C#
#########
#########
#########
#########

D 7
#####@ 
#######
#######
#######
#######
#######
#######

E 7
#######
#######
#######
#######
#######
##     
   ####

F 7
#######
    ###
###    
#######
#######
#######
#######

G 7
#######
#######
#######
###    
    ###
#######
#######

