C 9
#########
##     ##
##     ##
## D D !D#
##     ##
## A F  #
#@@#    #
#@##    #
#########

D 7
#     #
#     #
#     #
#     #
#     #
      #
      #

F 7
##### #
#####  
#######
#######
#######
#######
#######

