C 9
###     #
#@#     #
#!!!!C#     #
### !!C C #
#    A  #
# C !!!C !C #
#       #
#       #
#       #

