C 9
#### ####
#      C#
#       #
#  D C  #
#   A   #
###   # #
#@#     #
#@   #@##
#########

D 5
#####
#   #
#   #
#   #
#####

