C 9
#########
###@   ##
####@   #
#####   #
        #
 C D ####
     ####
 A ######
#########

D 5
#####
#@ ##
#  ##
## ##
## ##

