C 7
### ###
# C  C#
#     #
#     #
#@  A #
#@#   #
#######

