C 7
#######
#     #
# D C #
#  E  #
# F G #
#     #
### ###

D 5
#####
#   #
#   #
#   #
#####

E 7
#######
#@  ###
#   ###
#      
#   ###
#  @###
#######

F 5
#####
#   #
#   #
#   #
#####

G 5
#####
#   #
#   #
#   #
#####

