C 5
#####
##D##
##H##
#####
#####

D 7
#######
## H ##
       
       
       
G  A  F
       

G 5
#####
#   #
#   #
#   #
#####

F 5
#####
#   #
#   #
#   #
#####

H 7
       
   @   
   @   
   @   
       
## D ##
#######

