C 7
#######
#E    #
#   @ #
# G   #
# F D #
#     #
#######

E 3
###
 @#
###

G 5
#####
#   #
#   #
#   #
#####

F 5
#####
#   #
#   #
#   #
#####

D 3
###
 ##
###

