C 7
#######
#C   D#
#  @  #
# @@C #
#  @  #
#E   C#
### ###

D 5
#####
#  ##
#    
#####
#####

E 5
#####
#   #
#   #
#   #
#####

