C 11
###     ###
# ?D  #  # #
###     #C#
           
     @     
 # A@@@  # 
     @     
           
        #!C#
#F   #  # #
##      ###

D 3
# #
 # 
# #

F 11
##### ###C#
##### ### #
######### #
#########  
###########
#########  
###########
###########
###########
###########
###########

