C 9
#########
# !D @####
### #   #
###    D#
### @A  #
###    D#
### #   #
# ?E @####
#########

D 5
     
     
 #   
     
     

E 3
   
   
   

