C 7
#######
#     #
#D  H #
#  A  #
# D G #
#/?E    #
#######

D 5
#####
#####
##   
#####
#####

H 5
#####
#   #
#   #
#   #
#####

E 5
     
     
  @  
     
     

G 5
#####
#   #
#   #
#   #
#####

