C 7
#######
#F F  #
#     #
#G    #
#   A #
# /?D   #
#######

F 3
###
#  
# #

G 5
#####
#   #
#   #
#   #
#####

D 5
     
     
  @  
     
     

