C 9
#########
##@  D  #
##      #
## A GG #
##      #
#?L # FF #
#?J #    #
#?H # D  #
#########

G 3
###
 ##
###

L 5
#####
  M@#
 # ##
##   
#####

M 5
#####
#   #
#   #
#   #
#####

F 3
###
 ##
###

J 5
#####
  K@#
 # ##
##   
#####

K 5
#####
#   #
#   #
#   #
#####

H 5
#####
  I@#
 # ##
##   
#####

I 5
#####
#   #
#   #
#   #
#####

D 3
###
 ##
###

