C 9
#########
## ### ##
##!E E   #
#       #
#   A   #
#   @@@ #
#E      #
#########
#########

E 7
#     #
#     #
#     #
#     #
#     #
#     #
#######

