C 9
     ####
  A  ####
     ####
##C######
## # # @#
#    # ##
#### # ##
#### # ##
####   ##

