C 7
#######
 C ####
      #
    A #
#     #
EFG   #
@######

E 5
#####
#   #
#   #
#   #
#####

F 5
#####
#   #
#   #
#   #
#####

G 5
#####
#   #
#   #
#   #
#####

