C 9
######@E#
## # ##F#
 C    #G#
       H#
    A  I#
        #
#########
#########
#########

E 5
#####
#   #
#   #
#   #
#####

F 5
#####
#   #
#   #
#   #
#####

G 5
#####
#   #
#   #
#   #
#####

H 5
#####
#   #
#   #
#   #
#####

I 5
#####
#   #
#   #
#   #
#####

