C 9
#########
##@  !!!C###
#########
#       #
   !C D  #
#      A#
#  !!C C ##
#      ##
#########

D 5
     
     
     
     
     

