C 7
#######
#   #!!C#
# A # #
#   #@#
#    ##
# C !C #
#     #

