C 13
#############
####  A  ####
####     ####
###G  E @####
####     ####
#############
####     ####
####  F  ####
###E  @  G###
####  !E  ####
####     ####
######H######
#############

E 5
     
     
     
     
     

F 5
#####
#   #
#   #
#   #
#####

G 3
###
   
###

H 5
 # ##
@####
#####
#####
#####

