C 9
#########
##   ##@#
## A # !F#
##     ##
## F E ##
##     ##
##@   F##
#########
#########

F 5
     
     
     
     
     

E 5
#####
#   #
#   #
#   #
#####

