C 9
###     #
#@#   A #
#?D# #   #
### E H #
#       #
#C  F C #
#   #   #
##      #
##      #

D 5
     
     
#####
     
     

E 3
###
# #
# #

H 3
# #
# #
###

F 5
#####
#   #
#   #
#   #
#####

