C 9
#########
#@ ##   #
#@  # E #
###     #
####  F #
##      #
#F  !F A #
##      #
#########

E 5
#####
#   #
#   #
#   #
#####

F 3
   
   
   

