C 7
#######
#E  @@#
#   A #
###  ##
# ?D   #
### ###
#######

E 3
###
###
#E#

D 5
#####
     
     
     
     

