C 11
###########
##       ##
## !D D D ##
##  A    ##
## !F F   F#
##       ##
##### #####
#####@@####
######@@###
#######@###
###########

D 7
       
       
       
       
       
       
       

F 7
       
       
       
       
       
       
       

