C 9
#########
##  BBB #
#       #
#B F   /?H#
#B FA ###
#B F   ##
#B    G@#
#      ##
#########

F 3
#F#
F#F
#F#

H 3
   
   
   

G 3
# #
#  
###

