C 9
#       #
#       #
#D     E#
#   A   #
#G  #  C#
#       #
####    #
#?H@##C  #
#########

D 5
#####
#   #
#   #
#   #
#####

E 5
#####
#   #
#   #
#   #
#####

G 5
#####
#   #
#   #
#   #
#####

H 3
   
   
   

