C 9
#########
###  D D#
##      #
##      #
##?E @A@ #
##      #
#      ##
#### ####
#########

D 3
   
 # 
   

E 3
# #
 # 
# #

