C 9
#########
###   C  
##C      
#        
#   A  # 
#    @   
#        
#   #  ?E#
#      ##

E 7
### ###
### ###
#######
  ##   
# @  ##
# # ###
# F ###

F 5
#####
#   #
#   #
#   #
#####

