C 9
#########
#@  ##   
## ###   
##!C  #   
## #     
#### C@  
#C       
#    A@  
#       #

