C 7
#######
#D # @#
#    ##
#  A  #
#     #
#@ F#@#
#######

D 5
#####
#   #
#    
#   #
#####

F 5
#####
#   #
#   #
#   #
#####

