C 9
#########
#     C##
#  A   ##
#    ####
#    #D #
# ## ## #
#@##    #
#@####D #
#  ######

D 3
###
## 
###

