C 9
#########
#   D#@##
#  # #EF#
#  # ## #
#G #H   #
#########
         
  @   C  
    #    

D 5
#####
#   #
#   #
#   #
#####

E 5
#####
#   #
#   #
#   #
#####

F 5
#####
#   #
#   #
#   #
#####

G 5
     
     
     
     
     

H 5
#####
#   #
#   #
#   #
#####

