C 9
#########
#########
#     @##
# DE F ##
# GH   ##
#    A  #
#     #@#
#########
#########

D 5
#####
#   #
#   #
#   #
#####

E 5
#####
#   #
#   #
#   #
#####

F 5
#####
#   #
#   #
#   #
#   #

G 5
#####
#   #
#   #
#   #
#####

H 5
#####
#   #
#   #
#   #
#####

