C 9
#########
##C######
#    C  #
# #     #
#    A  #
#  @    #
#  @ D  #
#       #
#       #

D 3
#E#
#@#
###

E 5
#####
#   #
#   #
#   #
#####

