C 9
#       #
#       #
#       #
#   C   #
#C    A #
##  E   #
#C      #
#       #
#   @   #

E 3
###
#@#
# #

