C 9
#########
#       #
# A F   #
#      @#
##  E   #
##      #
#    # ##
#    # @#
#########

F 5
## ##
## ##
##   
#####
#####

E 5
#####
#   #
#   #
#   #
#####

