C 7
#######
#     #
#   F #
# @   #
##D A #
###   #
#######

F 5
#####
#   #
#   #
#   #
#####

D 5
## ##
#   #
#   #
# @ #
#####

