C 7
#######
#     #
#  E  #
#@@ A #
#  F  #
#     #
#######

E 3
   
 @ 
   

F 5
#####
#   #
#   #
#   #
#####

