#########
#  I###J#
#   #H  #
#     #@#
#A F ####
#     K##
#    # G#
#E   ##@#
#########