C 7
#######
#A    #
#A F  #
#     #
#    @#
##@####
#######

F 5
#####
#####
  ###
#@###
#####

