C 7
#######
#    ##
#  D @#
#    @#
#  /E ##
#    ##
#######

D 5
     
     
  @  
     
     

E 5
     
     
  F  
     
     

F 5
#####
#   #
#   #
#   #
#####

