C 7
#######
#    D#
#  A  #
#@   @#
#  A  #
#     #
#######

D 3
   
   
   

