C 9
#########
### #####
##C  F   
#        
##     # 
##D  A   
##       
##  #  @ 
##       

F 7
###G# #
###@# #
##### #
#####  
#######
#######
#######

G 5
#####
#   #
#   #
#   #
#####

D 7
#######
#######
#######
E@#####
#######
    ###
### ###

E 5
#####
#   #
#   #
#   #
#####

