C 9
#########
#########
#  @#####
#   #####
  A #####
#   #  #@
#   E    
#########
#########

E 7
### ###
#     #
#  # C#
#     #
# F   #
#     #
#######

F 5
#####
#   #
#   #
#   #
#####

