C 9
#########
#@      #
#   E A #
#       #
  #   C #
#       #
##### ###
####@ ###
#########

E 5
#####
#   #
#   #
#   #
#####

