C 7
#######
#     #
# G F #
#     #
# A E #
#     #
#######

G 5
#####
# @ #
#   #
#   #
## ##

F 3
###
###
#@#

E 3
###
###
#@#

