C 7
#######
#     #
# C D #
#     #
# A#  #
#    @#
### ###

D 5
#####
# @##
#    
#  ##
#####

