C 9
#########
#D    @@#
        #
     C  #
   A   @#
     F  #
        #
        #
        #

D 9
#########
#########
#####    
#####    
#####    
#####    
#####    
#########
#########

F 5
#####
#   #
#G#  
#@###
#####

G 5
#####
#   #
#   #
#   #
#####

