C 7
#######
#     #
# D E #
#     #
# A G #
#     #
#######

D 3
   
   
   
   
   

E 5
     
     
     

G 5
### #
###@#
#####
###@H
#####

H 5
#####
#   #
#   #
#   #
#####

