C 7
 ##   #
##  @ #
## D  #
##  @ #
# C A #
###  @#
#######

D 7
#######
       
       
       
       
       
       

