C 7
#######
#  A  #
#     #
# C D #
#     #
#  @  #
### ###

D 7
### ###
#  @  #
#     #
#     #
#  @  #
#     #
#######

