C 8
########
###  ###
###    #
###    #
#@  EA #
# #    #
#@#    #
########

E 5
     
     
   #F
   # 
   ##

F 5
#####
#   #
#   #
#   #
#####

