C 9
#########
#     @##
#      ##
# F A  ##
#      ##
# D    ##
#   #@###
#########
#########

F 5
#   #
#   #
#   #
#   #
#####

D 5
#####
     
     
     
#####

