C 9
#########
##     ##
## #   ##
#  E   ##
#    A###
# FG   ##
#     @@#
#      ##
#########

E 5
## ##
#####
 #   
## ##
## ##

F 5
#####
#   #
#   #
#   #
#####

G 5
#####
#   #
#   #
#   #
#####

