C 7
##     
#D     
    #  
   C   
  F #  
       
       

D 7
#######
#######
#######
#######
#####@#
#####B#
##### #

F 5
#####
#   #
#   #
#   #
#####

