C 7
#######
#######
#    ##
#AEF ##
#    ##
#######
#######

E 5
#####
#   #
#   #
#   #
#####

F 3
G @
  @
H@@

G 3
# #
###
###

H 3
###
###
# #

