C 11
###########
######## D#
#@        #
#      @ ##
#        ##
#    I   ##
#        ##
#  J     ##
#        ##
#D       ##
###########

D 7
#######
#######
#######
#######
#######
 G###E#
##### #

G 3
##@
 #H
   

H 5
#####
#   #
#   #
#   #
#####

E 3
@F 
## 
#  

F 5
#####
#   #
#   #
#   #
#####

I 3
#D#
DDD
#D#

J 7
### # #
### # #
##### #
  ###  
#######
###    
### ###

