C 9
#########
#     ###
#     D##
#  # E  #
#   F   #
#  G H  #
#       #
#       #
#########

D 3
###
#@ 
###

E 5
#####
#   #
#   #
#   #
#####

F 5
     
     
     
     
     

G 5
#####
#   #
#   #
#   #
#####

H 5
#####
#   #
#   #
#   #
#####

