C 7
#######
##    #
##A E #
##    #
#   D #
#     #
#######

E 5
#   #
#   #
#   #
#   #
#####

D 5
#####
#####
#####
#@###
# ###

