C 11
###########
####  #####
##    #####
## G  #####
## AF    ##
## D  #  ##
##    ## ##
####  ## ##
#######@ ##
######@  ##
###########

G 5
#####
#   #
#   #
#   #
#   #

F 5
#####
    #
    #
    #
#####

D 5
#   #
#   #
#   #
#   #
#####

