C 9
#########
##@   ###
##   B###
##   B###
##A  B###
##   B###
##   J###
#### E###
#########

J 7
#######
#######
###@###
###@###
###@###
###@###
### ###

E 3
   
   
   

