C 9
# ##### #
#@#     #
###    ##
#      ##
# A E  ##
#      ##
#   C  ##
#      ##
#########

E 9
#########
#########
#########
#########
#########
#########
#       #
#       #
#       #

