C 9
#########
#       #
#       #
#    E  #
#  #   A#
#    D  #
#       #
#       #
#########

E 7
#######
      #
      #
      #
      #
      #
#######

D 7
#######
#####@ 
#######
###    
###    
###    
#######

