C 9
#########
#E @#####
# ####  #
# H # G #
##    # #
####### #
## D  # #
##   F  #
#########

E 5
#####
#   #
#   #
#   #
#####

H 5
#####
#   #
#   #
#   #
#####

G 5
#####
#   #
#   #
#   #
#####

D 5
## ##
#####
 ### 
#####
## ##

F 5
#####
#   #
#   #
#   #
#####

