C 9
#########
#########
###  F  #
### #   #
## E#   #
##  # D #
### #   #
#@  #####
#########

F 5
#####
#   #
#   #
#   #
#####

E 5
#####
#   #
#   #
#   #
#####

D 5
#####
#####
 ### 
#####
#####

