C 5
#####
#E#D#
#   #
# D #
#####

E 5
#####
#   #
#   #
#   #
#####

D 5
     
     
  @@ 
     
     

