C 9
#########
#       #
#   A   #
#       #
#  C E  #
#       #
#   #@  #
#       #
#### ####

E 7
#######
#@    #
#     #
   @  #
#### ##
#######
#######

