C 7
#######
# D@  #
#  #  #
#     #
#     #
#     #
### ###

D 7
#######
# E@  #
#  #  #
#     #
#  @  #
#     #
### ###

E 7
#######
#  F  #
#  #  #
#     #
#     #
#     #
### ###

F 7
#######
# C@  #
#  #  #
#     #
#  A  #
#     #
### ###

