C 7
#######
#G  ###
#    ##
#   FE#
#    ##
#A  ###
#######

G 3
# #
###
###

F 5
## ##
##   
#####
#####
#####

E 5
#####
 @###
#####
#####
#####

