C 7
#######
#### E#
#    ##
#    ##
# A  B#
#   #@#
#######

E 3
BBB
BBB
BMB

M 3
###
## 
###

