C 11
###########
#@     # @#
# A       #
#  F D ####
#      ####
#  G H    #
#      # @#
## ## #####
##  #  ####
## @# @####
###########

F 7
#######
#######
#######
  ###  
#######
### ###
### ###

D 7
### ###
### ###
#######
  #####
#######
### ###
### ###

G 7
### ###
### ###
#######
  ###  
#######
#######
#######

H 7
### ###
### ###
#######
#####  
#######
### ###
### ###

