C 9
#########
#       #
#  F A  #
#       #
#  H E  #
#      ##
G # ##  #
# #  ##C#
#### ####

F 5
#####
#   #
#    
#   #
#####

H 5
#####
#####
#####
  ###
# ###

E 5
# ###
# ###
#  ##
## ##
## ##

G 5
#####
###@ 
#####
#####
#####

