C 7
#######
#     #
# @ F #
# @   #
# @ D #
#     #
#######

F 5
## ##
#   #
#   #
#   #
#####

D 5
#####
#  E#
#   #
#   #
## ##

E 5
#####
#   #
#   #
#   #
#####

