C 11
###########
#         #
#   C      
#   !C     #
#   !!C     #
#   !!!C     #
#   !!!!C   #  
#       ## 
########## 
###!!!!!C @#### 
###########

