C 7
#######
##E####
## ##@#
#    @#
#   A##
#    ##
#######

E 3
# #
  #
###

