C 9
#########
#####   #
###     #
### #   #
###@# ###
#   # #B#
# # #####
#   #####
#########

