C 7
#######
##   A#
##  ###
### ###
#######
###  @#
#######

