C 11
###########
######  ###
#####     #
#####     #
#####  D  #
#@@    #  #
##B##  F  #
##@##     #
#####     #
#######  ##
###########

D 3
   
   
   

F 3
   
   
   

