C 7
#######
#    A#
#  E  #
#  @  #
#     #
##    #
#######

E 3
###
#@ 
###

