C 9
##       
#   #    
#     A  
#        
#D  @@ # 
#        
#        
#C  C   #
#########

D 5
#####
#   #
#   #
#   #
#####

