C 9
#########
#########
####   ##
## D   ##
## #   ##
##@# # ##
## #   ##
##A######
#########

D 5
#####
#   #
#   #
#   #
#####

