C 9
#########
##      #
##      #
#     A #
#    @  #
#     E #
#       #
#       #
#########

E 3
###
#@ 
###

