C 7
#######
#######
#@ F ##
#  A @#
##E ###
##  ###
#######

F 5
#####
#   #
#   #
#   #
## ##

E 5
#####
#   #
#   #
#   #
#####

