C 9
#########
##@######
# @   ###
#     ###
# D C #  
#       #
# A F ###
#     ###
#########

D 5
#####
#   #
#   #
#   #
#####

F 3
  #
  #
  #

