C 9
#########
#@@#    #
#  #  # #
# C   # #
#A##  #  
#  #  ###
#  #   ##
####  ###
#########

