C 9
#########
#       #
#  #   D#
#  #    #
#@@#C    
####  A #
####    #
#########
#########

D 5
#####
#   #
#   #
#   #
#   #

