C 7
#######
#  @ @#
#     #
#  A  #
#     #
###E###
#######

E 5
     
     
     
     
##F##

F 5
     
     
     
 ### 
  G  

G 5
## ##
## H#
#   #
#   #
#   #

H 5
#####
#   #
  I #
#   #
## ##

I 5
#####
#   #
#   #
#   #
#####

