C 9
#########
#########
#@     ##
#   ## ##
#@A DF ##
#     ###
#@    ###
#########
#########

D 5
#####
#   #
#   #
#   #
#####

F 5
#####
#   #
#   #
#   #
#####

