C 9
#########
##@   ###
##   @###
##    ###
## A @###
##   E###
##   F###
##    ###
#########

E 3
###
  #
# #

F 5
#####
#   #
#   #
#   #
#####

