C 9
#########
#       #
#  A G  #
#    F  #
#  E H  #
#       #
####I####
#########
#########

G 5
#####
#   #
#   #
#   #
#####

F 5
#####
#   #
#   #
#   #
#####

E 5
     
     
     
     
     

H 5
#####
#   #
#   #
#   #
#####

I 5
## # 
## #@
## ##
## ##
#####

