C 9
# # #####
       ##
 # #     
       ##
#      !C#
#### A ##
#!!C@#   C#
# ##   ##
###### ##

