C 7
#######
##K#D##
#### ##
#### ##
##I# @#
## # ##
#######

K 5
## ##
## ##
## ##
## ##
#####

D 9
  ##K  ##
  ###  ##
    #    
## ### ##
         
    A    
    A    
    A    
    A    

I 3
###
###
##A

