C 7
#######
## A  #
##    #
#E    F
##    #
###G###
#######

E 7
#######
#     #
#     #
#C#    
#     #
#     #
#######

F 5
#####
#####
 @#@ 
#####
#####

G 9
#### ####
##     ##
##  #  ##
##     ##
## H J ##
##     ##
## I K ##
##  #  ##
#########

H 5
#####
#   #
#   #
#   #
#####

J 5
#####
#   #
#   #
#   #
#####

I 3
# #
  #
###

K 5
#####
#   #
#   #
#   #
#####

