C 9
#########
######  #
###### G#
#       #
#  @ A  #
#       #
#  @ E  #
#       #
#########

G 5
#####
#   #
#   #
#   #
#####

E 3
###
F@#
###

F 5
#####
#   #
#   #
#   #
#####

