C 9
#########
#@  #####
#@  #####
#   #####
###     #
### E F #
### D A #
###     #
#########

E 3
###
 @#
###

F 5
#####
#   #
#   #
#   #
#####

D 5
#####
#   #
     
#   #
#####

