C 7
#######
# E  ##
#     #
# @@  #
# A F #
#     #
#######

E 5
     
     
     
     
     

F 3
###
G@#
###

G 5
#####
#   #
#   #
#   #
#####

