C 9
#########
##  @  ##
##     ##
## E F ##
##     ##
##  @  ##
##  A  ##
##@    ##
#########

E 7
#######
###  ##
##   ##
##    #
#     #
#    ##
### ###

F 3
###
G@#
###

G 5
#####
#   #
#   #
#   #
#####

