C 9
#########
# E#    #
# ##    #
#   A E #
##      #
##  F G #
##      #
##      #
#########

E 3
   
   
   

F 3
   
   
   

G 9
##### ###
#####@###
#########
#########
#########
#########
#########
#########
#########

