C 7
#######
#    ##
# I D##
#    ##
# @   #
# @ ###
#######

I 5
#####
#   #
#   #
#   #
#####

D 7
### ###
# #H  #
#E #  #
#      
#F  A #
##   @#
#######

H 5
#####
#   #
#   #
#   #
#####

E 5
   ##
# ###
  ## 
# #  
    #

F 7
# # ###
#    ##
# #####
       
   ####
#######
#######

