C 7
#######
##   A#
## EF #
##    #
#    @#
#@#####
#######

E 7
       
       
       
       
####   
###    
### ###

F 5
#####
#   #
#   #
#   #
#####

