C 9
#########
##      #
## D E  #
##   F  #
## G H  #
##   I  #
#J # K  #
#@##    #
#########

D 5
#####
#   #
#   #
#   #
#####

E 5
#####
#   #
#   #
#   #
#####

F 5
#####
#   #
#   #
#   #
#####

G 5
     
     
     
     
     

H 5
#####
#   #
#   #
#   #
#####

I 5
#####
#   #
#   #
#   #
#####

J 5
#####
#   #
#   #
#   #
#####

K 5
#####
#   #
#   #
#   #
#####

