C 9
#########
##     ##
##     ##
## EFD  #
##      #
## GIH  #
##     ##
##     ##
#########

E 5
#####
#   #
#   #
#   #
#####

F 3
   
  @
   

D 5
#####
#   #
#   #
#   #
#####

G 5
#####
#   #
#   #
#   #
#####

I 5
#####
#   #
#   #
#   #
#####

H 5
#####
#   #
#   #
#   #
#####

