C 9
#########
#       #
#  @@@  #
# D   C #
#   #   #
# A   E #
#       #
#       #
#### ####

D 5
#####
#   #
#   #
#   #
#####

E 9
#########
###     #
##@ #   #
###     #
        #
#       #
#       #
#       #
#########

