C 9
#########
#       #
#       #
#   C   #
##    A #
#   D   #
#       #
#       #
#### ####

D 7
#######
# @ @ #
#     #
#      
#     #
#  @  #
#######

