C 9
#########
#       #
#       #
#  C G  #
#   A   #
#  D E  #
#       #
#       #
#### ####

G 9
#########
#       #
#       #
#  @ @  #
    @   #
#  @ @  #
#       #
#       #
#########

D 9
#########
#       #
#       #
#       #
#        
#       #
#       #
#       #
#########

E 9
#### ####
##      #
##      #
#       #
#       #
#       #
#       #
#       #
#########

