C 9
#########
#   #####
#D    ###
#     ###
    A ###
#     ###
# C   ###
#     ###
#########

D 7
#######
#@    #
#     #
#    ##
#    @#
#   #@#
### ###

