C 7
#######
#     #
# A  D#
#     #
#     #
#    C#
# C  ##

D 7
# #####
#@#####
#######
#######
#######
#######
#######

