C 7
#######
#   D #
#@#   #
##    #
#     #
#    @#
### ###

D 7
#######
#  E  #
#     #
# G   #
#  #  #
#     #
### ###

E 5
#####
# C #
#   #
# A #
## ##

G 5
#####
#   #
#   #
#   #
#####

