C 9
#########
#E      #
#      C#
#       #
    A    
#       #
#C    ###
#   #  @#
#########

E 3
###
 @#
###

