C 9
#########
#     ###
#     ###
# A C ###
      ###
# F D ###
#     ###
#   #####
#########

F 7
### ###
### ###
### ###
#@  ###
#  @###
#@@####
#######

D 5
#####
#   #
#   #
#   #
#####

