C 9
#########
#########
#  #C####
#A #D @##
#   F####
# H G####
#   I####
#  #J @##
#  #K####

D 5
#####
#   #
#   #
#   #
#####

F 5
#####
#   #
#   #
#   #
#####

H 5
#####
#   #
#   #
#   #
#####

G 5
#####
#   #
#   #
#   #
#####

I 5
#####
#   #
#   #
#   #
#####

J 5
## ##
#   #
     
#   #
## ##

K 5
#####
#   #
#   #
#   #
#####

