C 9
####E####
##@ J####
####K   #
####F A #
####C   #
####G M #
####H   #
####I####
####L####

E 5
#####
     
     
     
#####

J 5
#####
#   #
#   #
#   #
#####

K 5
#####
     
     
     
     

F 5
#####
#   #
#   #
#   #
#####

G 5
#####
#   #
#   #
#   #
#####

M 3
###
## 
###

H 5
#####
     
M    
     
#####

I 5
#####
#   #
#   #
#   #
#####

L 5
     
     
     
     
#####

