C 9
#########
#     ###
# A E #C#
#     #F#
# J G  H#
#     #I#
#   K #M#
#J    #N#
#######L#

E 5
#####
#   #
#   #
#   #
#####

F 5
#####
#   #
#   #
#   #
#####

J 3
   
   
   

G 5
#####
#   #
#   #
#   #
#####

H 5
#####
     
     
     
     

I 5
#####
#   #
#   #
#   #
#####

K 5
#####
#   #
#   #
#   #
#####

M 3
###
 @#
###

N 5
#####
#   #
#   #
#   #
#####

L 5
#####
#   #
#   #
#   #
#####

