C 7
#######
#     #
# A G #
# H D #
#     #
###F###
#######

G 5
#####
#   #
#   #
#   #
#####

H 5
#####
#   #
#   #
#   #
#####

D 5
     
     
  #  
     
     

F 5
  #  
     
# @ #
     
  #  

