C 9
#########
#       #
#       #
#  F J  #
#   A  @#
#  D G  #
#       #
#       #
#########

F 5
#####
#   #
#   #
#   #
#####

J 5
#####
#   #
#   #
#   #
#####

D 5
### #
### #
###  
### #
### #

G 5
###I#
###@#
#####
###@#
###H#

I 5
#####
#   #
#   #
#   #
#####

H 5
#####
#   #
#   #
#   #
#####

