C 9
#########
#########
#### ####
# E   D #
#   A   #
#   @ @ #
#       #
#########
#########

E 5
#####
#####
#####
#####
# ###

D 5
# ###
# ###
#  ##
## ##
## ##

