C 7
#######
#     #
# D H #
#     #
# G A #
#    @#
#######

D 5
#####
###@E
#####
#@###
#F###

E 5
#####
#   #
#   #
#   #
#####

F 5
#####
#   #
#   #
#   #
#####

H 5
#####
#   #
#   #
#   #
#####

G 5
     
  #  
 ### 
  #  
     

