C 9
#########
#     ###
# A E  ##
#      ##
# G H  ##
#      ##
# F I  ##
#     ###
#########

E 5
### #
#   #
#@  #
#   #
### #

G 5
#####
#   #
#   #
#   #
#   #

H 5
#####
#   #
#   #
#   #
#####

F 5
#   #
#   #
#   #
#   #
#####

I 5
#   #
#   #
#   #
#   #
#####

