C 9
#########
#       #
#       #
#  E F  #
## EAF ##
#  E F  #
#       #
#       #
#########

E 9
#########
#######  
####### #
  #####  
# #######
  #######
#########
#########
#########

F 9
#### ####
     ####
#########
#########
#########
#######  
####### #
 @#####  
#########

