C 9
#########
#       #
#       #
#  A F  #
#  E F  #
#  E F  #
#       #
#       #
#########

E 7
#######
#####  
##### #
##### #
##### #
#####  
#######

F 7
#######
 @#####
#######
  #####
# #####
  #####
#######

