C 7
#######
#@    #
#   D #
#    A#
#   G #
###   #
#######

D 5
# #E#
# #@#
# ###
#  ##
## ##

E 5
#####
#   #
#   #
#   #
#####

G 5
## ##
##  #
### #
#@# #
#H# #

H 5
#####
#   #
#   #
#   #
#####

