C 9
#########
#########
#     D #
#  #    #
#@ # EF #
#@@#    #
####  A #
#########
#########

D 5
#####
#####
#   #
#   #
##  #

E 3
# #
  #
###

F 5
#####
#   #
#   #
#   #
#####

