C 9
#########
###    ##
###D  E##
###  @ ##
    A@   
###  @ ##
###  C ##
###@   ##
#########

D 5
#####
#   #
#   #
#   #
#####

E 5
#####
#   #
#   #
#   #
#####

