C 7
#######
#     #
# D E #
#@   @#
# F A #
#     #
#######

D 7
#######
      #
      #
   @  #
#     #
#     #
#######

E 5
#####
#   #
#   #
#   #
#####

F 7
#######
#     #
#     #
#  @   
#      
#      
#######

