C 7
#######
#A#####
# #EEE#
# #EEE#
# #EEE#
#E#####
#######

E 7
      #
 ##    
      #
   @  #
     F#
## ## #
 @  # #

F 5
#####
#   #
#   #
#   #
#####

