C 7
#######
#A#####
# #####
# ##EE#
# ##EE#
#E#####
#######

E 5
BB BV
BBBBB
B]BBB
BBBBB
BBIBB

V 5
### #
### #
###  
#@###
# ###

] 5
#####
  ###
# ###
#    
# ###

I 5
# ###
#    
#####
     
### #

