C 11
###########
#@     ####
#@        #
#    E    #
#         #
  #  A ##  
##     ####
##C       #
#    # #@##
### #  ####
##### #####

E 5
#####
#   #
#   #
#   #
#####

