C 9
#########
###@    #
# #     #
#@# E   #
#     #  
#@# C A #
# #     #
###     #
#########

E 5
## ##
#   #
#   #
#   #
## ##

