######
#    #
# A  #
#  @ #
#    #
######